####################
####              O#
##   # # ###########
##   # # #O        #
##   # # #         #
##   # # ########  #
##   # # #      #  #
##     # #      #  #
## X   # #  X#  #  #
###  ### #   #     #
#OX  ### P   #     #
######## #   #######
#    O#  #         #
#  ####X##  X      #
#    #   ########  #
#    #   #         #
#    ###  #  #######
#         #        #
#################  #
#################  #
#O                 #
####################