########
# X  P #
#      #
#OX    #
#   X  #
########