#########
###  ####
#     X #
# #  #X #
# O O#P #
#########