############
# P  R     #
#    R     #
#    R  R  #
#    RO RX #
#    RRRR  #
############