########
#O PX  #
#      #
# O XS #
#      #
########