#########
# P    O#
#    ####
#       #
#   XX  #
#       #
#####   #
#O      #
#########