#####
#O  #
#X#P#
#   #
#####

   #####
   #   #
   # # #
   #   #
   #####